111111111111111111111111111111111111111111111111111111111111111111111111111111111111111111111111111111111111111111111
10110000000C0110000000C0110000000C0110000000C0110000000C0110000000C0110000000C0110000000C0110000000C0110000000C011001
10000111110C0000111110C0000111110C0000111110C0000111110C0000111110C0000111110C0000111110C0000111110C0000111110C000011
100C1100E0000110000000C00110000000C00110000000C00110000000C00110000000C00110000000C00110000000C00110000000C0011000001
1011000000TC0110000000C0110000000C0110000000C0110000000C0110000000C0110000000C0110000000C0110000000C0110000000C011001
10000111110C0000111110C0000111110C0000111110C0000111110C0000111110C0000111110C0000111110C0000111110C0000111110C000011
100C1100E0000110000000C00110000000C00110000000C00110000000C00110000000C00110000000C00110000000C00110000000C0011000001
10110000000C0110000000C0110000000C0110000000C0110000000C0110000000C0110000000C0110000000C0110000000C0110000000C011001
10000111110C0000111110C0000111110C0000111110C0000111110C0000111110C0000111110C0000111110C0000111110C0000111110C000011
1P0000000000000000000000000000000000000000000000000000000000000000000000000000000000000000000000000000000000000000001
10110000000C0110000000C0110000000C0110000000C0110000000C0110000000C0110000000C0110000000C0110000000C0110000000C011001
10000111110C0000111110C0000111110C0000111110C0000111110C0000111110C0000111110C0000111110C0000111110C0000111110C000011
100C1100E0000110000000C00110000000C00110000000C00110000000C00110000000C00110000000C00110000000C00110000000C0011000001
10110000000C0110000000C0110000000C0110000000C0110000000C0110000000C0110000000C0110000000C0110000000C0110000000C011001
10000111110C0000111110C0000111110C0000111110C0000111110C0000111110C0000111110C0000111110C0000111110C0000111110C000011
100C1100E0000110000000C00110000000C00110000000C00110000000C00110000000C00110000000C00110000000C00110000000C0011000001
10110000000C0110000000C0110000000C0110000000C0110000000C0110000000C0110000000C0110000000C0110000000C0110000000C011001
10000111110C0000111110C0000111110C0000111110C0000111110C0000111110C0000111110C0000111110C0000111110C0000111110C000011
100C1100E0000110000000C00110000000C00110000000C00110000000C00110000000C00110000000C00110000000C00110000000C0011000001
10110000000C0110000000C0110000000C0110000000C0110000000C0110000000C0110000000C0110000000C0110000000C0110000000C011001
10000111110C0000111110C0000111110C0000111110C0000111110C0000111110C0000111110C0000111110C0000111110C0000111110C000011
100C1100E0000110000000C00110000000C00110000000C00110000000C00110000000C00110000000C00110000000C00110000000C0011000001
10110000000C0110000000C0110000000C0110000000C0110000000C0110000000C0110000000C0110000000C0110000000C0110000000C011001
10000111110C0000111110C0000111110C0000111110C0000111110C0000111110C0000111110C0000111110C0000111110C0000111110C000011
100C1100E0000110000000C00110000000C00110000000C00110000000C00110000000C00110000000C00110000000C00110000000C0011000001
10110000000C0110000000C0110000000C0110000000C0110000000C0110000000C0110000000C0110000000C0110000000C0110000000C011001
10000111110C0000111110C0000111110C0000111110C0000111110C0000111110C0000111110C0000111110C0000111110C0000111110C000011
100C1100E0000110000000C00110000000C00110000000C00110000000C00110000000C00110000000C00110000000C00110000000C0011000001
10110000000C0110000000C0110000000C0110000000C0110000000C0110000000C0110000000C0110000000C0110000000C0110000000C011001
10000111110C0000111110C0000111110C0000111110C0000111110C0000111110C0000111110C0000111110C0000111110C0000111110C000011
100C1100E0000110000000C00110000000C00110000000C00110000000C00110000000C00110000000C00110000000C00110000000C0011000001
10110000000C0110000000C0110000000C0110000000C0110000000C0110000000C0110000000C0110000000C0110000000C0110000000C011001
10000111110C0000111110C0000111110C0000111110C0000111110C0000111110C0000111110C0000111110C0000111110C0000111110C000011
100C1100E0000110000000C00110000000C00110000000C00110000000C00110000000C00110000000C00110000000C00110000000C0011000001
10110000000C0110000000C0110000000C0110000000C0110000000C0110000000C0110000000C0110000000C0110000000C0110000000C011001
10000111110C0000111110C0000111110C0000111110C0000111110C0000111110C0000111110C0000111110C0000111110C0000111110C000011
100C1100E0000110000000C00110000000C00110000000C00110000000C00110000000C00110000000C00110000000C00110000000C0011000001
10110000000C0110000000C0110000000C0110000000C0110000000C0110000000C0110000000C0110000000C0110000000C0110000000C011001
10000111110C0000111110C0000111110C0000111110C0000111110C0000111110C0000111110C0000111110C0000111110C0000111110C000011
100C1100E0000110000000C00110000000C00110000000C00110000000C00110000000C00110000000C00110000000C00110000000C0011000001
100C1100E0000110000000C00110000000C00110000000C00110000000C00110000000C00110000000C00110000000C00110000000C0011000001
100C1100E0000110000000C00110000000C00110000000C00110000000C00110000000C00110000000C00110000000C00110000000C0011000001
111111111111111111111111111111111111111111111111111111111111111111111111111111111111111111111111111111111111111111111