111111111111111111
1E0000000000100001
1010T1010000010101
1010010010C0110101
1P00000000001000C1
111111111111111111
