1111111111111
1011000T000C1
10000000000C1
1P0C110E00001
1111111111111