1111111111111
10110000000C1
10000000C00C1
1P0C110E0T001
100000U000001
1000000000001
1111111111111