111111111111111111
1E0000000000000001
1010T1010000010101
1010010010C0010101
1P00000000000000C1
111111111111111111
